segment	片段
History Completion	历史完成
History Prediction	历史预测
term	术语	原来的版本翻译为词语，译为术语更加合适
Glossary	术语表	glossary of terms，意为术语表。term是glossary的一个entry
shortcut	缩略词	在autotext功能中出现，可以输入缩略词，自动补全单词。比如输入ad.补全为advertisement
Preferences	偏好设置
Change	修改
domain	领域	查询TaaS术语时可以选择特定的领域
API Key	API Key	专业名词就不翻译了
Active	活动的	active segment，就是当前所在片段
unique	唯一	根据以下文档，可以知道unique segment是不存在重复的唯一片段。Segments which occur more than once are described in OmegaT as "non-unique segments".
spreadsheet	电子表格
Drag and drop	拖放
Search and Replace	搜索与替换
bidirectional control characters	双向控制字符
Auto-Populated Segments	自动填充片段
Options/Editing Behaviour	选项/编辑操作
Request For Enhancement	增强需求
Aggressive Font Fallback	突出后备字体
Note	提示
